//MAP CONVERTED BY dmm2tgm.py THIS HEADER COMMENT PREVENTS RECONVERSION, DO NOT REMOVE
"a" = (
/turf/closed/wall/mineral/abductor,
/area/space)
"f" = (
/obj/machinery/abductor/pad{
	dir = 4
	},
/turf/open/floor/mineral/abductor,
/area/space)
"h" = (
/turf/open/floor/plating/abductor2,
/area/space)
"i" = (
/obj/structure/table/abductor,
/turf/open/floor/mineral/abductor,
/area/space)
"k" = (
/obj/structure/table/optable/abductor,
/turf/open/floor/mineral/abductor,
/area/space)
"p" = (
/turf/open/space/basic,
/area/space)
"q" = (
/obj/machinery/power/smes/shuttle/precharged{
	dir = 4
	},
/turf/open/floor/plating/abductor2,
/area/space)
"r" = (
/obj/machinery/power/smes/shuttle/precharged{
	dir = 4
	},
/turf/open/floor/mineral/abductor,
/area/space)
"t" = (
/obj/machinery/power/shuttle/engine/electric{
	dir = 4
	},
/turf/open/floor/mineral/abductor,
/area/space)
"u" = (
/obj/machinery/door/airlock/abductor,
/turf/open/floor/mineral/abductor,
/area/space)
"x" = (
/obj/machinery/abductor/pad,
/turf/open/floor/mineral/abductor,
/area/space)
"y" = (
/obj/machinery/computer/camera_advanced/abductor,
/turf/open/floor/mineral/abductor,
/area/space)
"E" = (
/obj/machinery/power/shuttle/engine/electric{
	dir = 4
	},
/turf/open/floor/plating/abductor2,
/area/space)
"G" = (
/obj/machinery/door/airlock/abductor,
/turf/open/floor/plating/abductor2,
/area/space)
"K" = (
/obj/effect/spawner/structure/window/plasma/reinforced/shutters,
/turf/open/floor/mineral/abductor,
/area/space)
"L" = (
/obj/machinery/abductor/experiment,
/turf/open/floor/mineral/abductor,
/area/space)
"N" = (
/obj/machinery/chem_dispenser/abductor,
/turf/open/floor/mineral/abductor,
/area/space)
"Q" = (
/obj/machinery/abductor/gland_dispenser,
/turf/open/floor/mineral/abductor,
/area/space)
"T" = (
/obj/machinery/power/terminal{
	dir = 8
	},
/turf/open/floor/mineral/abductor,
/area/space)
"V" = (
/turf/open/floor/mineral/abductor,
/area/space)
"W" = (
/obj/machinery/abductor/console,
/turf/open/floor/mineral/abductor,
/area/space)
"X" = (
/obj/machinery/power/terminal{
	dir = 8
	},
/turf/open/floor/plating/abductor2,
/area/space)

(1,1,1) = {"
p
p
p
p
p
p
p
p
p
p
p
p
p
p
a
G
a
p
p
p
p
p
p
p
p
p
p
p
p
p
p
"}
(2,1,1) = {"
p
p
p
p
p
p
p
p
p
p
p
a
a
a
a
h
a
a
a
a
p
p
p
p
p
p
p
p
p
p
p
"}
(3,1,1) = {"
p
p
p
p
p
p
p
p
p
p
p
a
h
h
a
G
a
h
h
a
p
p
p
p
p
p
p
p
p
p
p
"}
(4,1,1) = {"
p
p
p
p
p
p
p
p
p
p
p
a
h
h
h
h
h
h
h
a
p
p
p
p
p
p
p
p
p
p
p
"}
(5,1,1) = {"
p
p
p
p
p
p
p
p
p
p
a
a
a
a
h
h
h
a
a
a
a
p
p
p
p
p
p
p
p
p
p
"}
(6,1,1) = {"
p
p
p
p
p
p
p
p
p
p
a
h
h
h
h
h
h
h
h
h
a
p
p
p
p
p
p
p
p
p
p
"}
(7,1,1) = {"
p
p
p
p
p
p
p
p
p
p
a
h
h
h
h
h
h
h
h
h
a
p
p
p
p
p
p
p
p
p
p
"}
(8,1,1) = {"
p
p
p
p
p
p
t
t
p
p
a
a
a
a
h
h
h
a
a
a
a
p
p
E
E
p
p
p
p
p
p
"}
(9,1,1) = {"
p
p
p
p
a
a
r
r
a
a
a
h
h
h
h
h
h
h
h
h
a
a
a
q
q
a
a
p
p
p
p
"}
(10,1,1) = {"
p
p
a
a
a
V
T
T
V
V
a
h
h
h
h
h
h
h
h
h
a
h
h
X
X
h
a
a
a
p
p
"}
(11,1,1) = {"
p
p
a
V
V
V
V
V
V
V
a
a
a
a
V
V
V
a
a
a
a
h
h
h
h
h
h
h
a
p
p
"}
(12,1,1) = {"
p
a
a
a
a
a
u
u
a
a
a
V
V
a
V
V
V
a
h
h
G
h
h
h
h
h
h
h
a
a
p
"}
(13,1,1) = {"
p
a
V
V
V
V
V
V
V
V
V
V
V
a
V
V
V
a
h
h
a
a
u
a
a
a
a
a
a
a
p
"}
(14,1,1) = {"
p
a
V
V
V
V
V
V
V
V
V
V
V
a
V
V
V
a
h
a
a
V
V
V
a
a
h
h
h
a
p
"}
(15,1,1) = {"
p
a
V
V
V
V
V
V
V
V
V
V
V
a
V
V
V
a
a
a
V
V
V
V
Q
a
a
h
h
a
p
"}
(16,1,1) = {"
p
a
V
V
V
V
V
V
V
V
V
V
V
a
V
V
V
a
L
V
V
V
V
V
V
V
a
h
h
a
p
"}
(17,1,1) = {"
p
a
V
V
V
V
V
V
V
V
V
V
V
u
V
V
V
u
V
V
V
V
k
V
V
V
u
h
h
a
p
"}
(18,1,1) = {"
p
a
V
V
V
V
V
V
V
V
V
V
V
a
V
V
V
a
f
V
V
V
i
V
V
V
a
h
h
a
p
"}
(19,1,1) = {"
p
a
V
V
V
V
V
V
V
V
V
V
V
a
V
V
V
a
a
a
V
V
V
V
N
a
a
h
h
a
p
"}
(20,1,1) = {"
p
a
a
a
a
a
a
a
V
V
V
V
V
a
V
V
V
a
h
a
a
V
V
V
a
a
h
h
a
a
p
"}
(21,1,1) = {"
p
p
a
V
V
V
V
a
V
V
V
V
V
a
V
V
V
a
h
h
a
a
u
a
a
h
h
h
a
p
p
"}
(22,1,1) = {"
p
p
a
V
V
V
V
u
V
V
V
V
V
a
V
V
V
a
h
h
h
h
h
h
h
h
h
h
a
p
p
"}
(23,1,1) = {"
p
p
a
V
V
V
V
a
V
V
V
V
V
a
V
V
V
a
h
h
h
h
h
h
h
h
h
h
a
p
p
"}
(24,1,1) = {"
p
p
p
a
a
a
a
a
a
u
a
a
a
a
a
u
a
a
a
a
a
a
a
a
a
a
a
a
p
p
p
"}
(25,1,1) = {"
p
p
p
a
a
V
V
V
V
V
V
a
y
V
V
V
V
V
V
a
h
h
h
h
h
h
a
a
p
p
p
"}
(26,1,1) = {"
p
p
p
p
a
a
V
V
V
V
V
a
x
V
V
V
V
V
V
a
h
h
h
h
h
a
a
p
p
p
p
"}
(27,1,1) = {"
p
p
p
p
p
a
a
V
V
V
V
a
i
V
V
V
V
V
V
u
h
h
h
h
a
a
p
p
p
p
p
"}
(28,1,1) = {"
p
p
p
p
p
p
a
a
a
V
V
a
L
V
V
V
V
V
V
a
h
h
a
a
a
p
p
p
p
p
p
"}
(29,1,1) = {"
p
p
p
p
p
p
p
p
a
a
a
a
W
V
V
V
V
V
V
a
a
a
a
p
p
p
p
p
p
p
p
"}
(30,1,1) = {"
p
p
p
p
p
p
p
p
p
p
p
a
K
K
K
K
K
K
K
a
p
p
p
p
p
p
p
p
p
p
p
"}
(31,1,1) = {"
p
p
p
p
p
p
p
p
p
p
p
p
p
p
p
p
p
p
p
p
p
p
p
p
p
p
p
p
p
p
p
"}
