//MAP CONVERTED BY dmm2tgm.py THIS HEADER COMMENT PREVENTS RECONVERSION, DO NOT REMOVE
"aZ" = (
/obj/effect/turf_decal/atmos/plasma,
/turf/open/floor/engine/plasma,
/area/template_noop)
"bs" = (
/obj/machinery/atmospherics/pipe/simple/orange/visible{
	dir = 9
	},
/obj/machinery/atmospherics/pipe/simple/scrubbers/hidden/layer2{
	dir = 5
	},
/turf/open/floor/engine,
/area/template_noop)
"bI" = (
/obj/structure/cable/yellow{
	icon_state = "4-8"
	},
/turf/open/floor/plasteel/tech,
/area/template_noop)
"bM" = (
/obj/machinery/atmospherics/components/unary/outlet_injector/atmos/nitrogen_input{
	dir = 8
	},
/turf/open/floor/engine/n2,
/area/template_noop)
"bW" = (
/obj/machinery/atmospherics/pipe/simple/orange/visible{
	dir = 4
	},
/turf/closed/wall/mineral/plastitanium,
/area/template_noop)
"cj" = (
/obj/machinery/air_sensor/atmos/air_tank,
/turf/open/floor/engine/air,
/area/template_noop)
"cF" = (
/obj/machinery/atmospherics/pipe/simple/dark/visible{
	dir = 6
	},
/turf/open/floor/plasteel/tech,
/area/template_noop)
"cW" = (
/obj/machinery/atmospherics/components/binary/circulator/cold{
	dir = 1
	},
/turf/open/floor/plasteel/tech,
/area/template_noop)
"dh" = (
/obj/machinery/atmospherics/pipe/simple/dark/visible{
	dir = 1
	},
/obj/machinery/atmospherics/pipe/simple/scrubbers/hidden/layer4{
	dir = 10
	},
/turf/open/floor/plasteel/tech,
/area/template_noop)
"eu" = (
/obj/machinery/air_sensor/atmos/incinerator_tank,
/obj/machinery/igniter/incinerator_atmos,
/turf/open/floor/engine/vacuum,
/area/template_noop)
"eZ" = (
/obj/machinery/atmospherics/pipe/simple/orange/visible,
/obj/machinery/atmospherics/pipe/simple/supply/hidden/layer2{
	dir = 6
	},
/obj/machinery/advanced_airlock_controller/mix_chamber{
	pixel_y = 26
	},
/turf/open/floor/engine,
/area/template_noop)
"fE" = (
/obj/structure/cable{
	icon_state = "2-4"
	},
/obj/structure/cable{
	icon_state = "1-4"
	},
/obj/structure/cable{
	icon_state = "4-8"
	},
/turf/open/floor/plasteel/tech,
/area/template_noop)
"fZ" = (
/obj/machinery/atmospherics/pipe/simple/dark/visible{
	dir = 1
	},
/turf/open/floor/plasteel/tech,
/area/template_noop)
"gj" = (
/obj/effect/turf_decal/atmos/air,
/turf/open/floor/engine/air,
/area/template_noop)
"gs" = (
/obj/machinery/power/smes/shuttle/precharged{
	dir = 4
	},
/obj/structure/cable{
	icon_state = "0-8"
	},
/obj/machinery/door/window/eastleft{
	name = "Engine Access"
	},
/turf/open/floor/plating,
/area/template_noop)
"gt" = (
/obj/machinery/atmospherics/pipe/layer_manifold,
/turf/open/floor/plasteel/tech,
/area/template_noop)
"gZ" = (
/obj/machinery/power/smes/engineering,
/obj/structure/cable{
	icon_state = "0-8"
	},
/turf/open/floor/plasteel/tech,
/area/template_noop)
"if" = (
/obj/machinery/atmospherics/pipe/simple/cyan/visible/layer5,
/obj/structure/cable{
	icon_state = "1-2"
	},
/obj/machinery/atmospherics/pipe/simple/supply/hidden/layer2,
/obj/machinery/atmospherics/pipe/manifold/scrubbers/hidden/layer4{
	dir = 4
	},
/turf/open/floor/plasteel/tech,
/area/template_noop)
"in" = (
/obj/machinery/atmospherics/pipe/simple/green/visible,
/obj/machinery/atmospherics/pipe/simple/supply/hidden/layer2{
	dir = 4
	},
/turf/open/floor/plasteel/tech,
/area/template_noop)
"iB" = (
/turf/template_noop,
/area/template_noop)
"iV" = (
/obj/machinery/atmospherics/pipe/simple/supply/hidden/layer2{
	dir = 4
	},
/turf/closed/wall/mineral/plastitanium,
/area/template_noop)
"iY" = (
/obj/structure/window/plasma/reinforced/plastitanium,
/turf/open/floor/plasteel/patterned/grid,
/area/template_noop)
"jA" = (
/obj/machinery/atmospherics/pipe/simple/cyan/visible,
/obj/structure/cable{
	icon_state = "1-2"
	},
/obj/machinery/atmospherics/pipe/simple/supply/hidden/layer2,
/obj/machinery/atmospherics/pipe/simple/scrubbers/hidden/layer4{
	dir = 1
	},
/turf/open/floor/plasteel/tech,
/area/template_noop)
"kR" = (
/obj/structure/cable{
	icon_state = "1-2"
	},
/obj/machinery/atmospherics/pipe/simple/scrubbers/hidden/layer4{
	dir = 1
	},
/turf/open/floor/plasteel/tech,
/area/template_noop)
"lc" = (
/obj/structure/cable{
	icon_state = "2-8"
	},
/turf/open/floor/plasteel/tech,
/area/template_noop)
"mb" = (
/obj/machinery/atmospherics/pipe/simple/green/visible,
/turf/open/floor/plasteel/tech,
/area/template_noop)
"mc" = (
/obj/machinery/atmospherics/pipe/simple/general/visible/layer4{
	dir = 9
	},
/turf/closed/wall/mineral/plastitanium,
/area/template_noop)
"nl" = (
/obj/machinery/atmospherics/pipe/simple/orange/visible{
	dir = 10
	},
/turf/open/floor/plasteel/tech,
/area/template_noop)
"nA" = (
/obj/effect/turf_decal/atmos/nitrogen,
/turf/open/floor/engine/n2,
/area/template_noop)
"oa" = (
/obj/structure/cable/yellow{
	icon_state = "2-4"
	},
/obj/machinery/atmospherics/pipe/simple/dark/visible{
	dir = 10
	},
/obj/machinery/atmospherics/pipe/simple/scrubbers/hidden/layer4,
/turf/open/floor/plasteel/tech,
/area/template_noop)
"oV" = (
/obj/machinery/atmospherics/components/unary/vent_pump/siphon/atmos/incinerator_output{
	dir = 4
	},
/turf/open/floor/engine/vacuum,
/area/template_noop)
"pn" = (
/obj/structure/cable{
	icon_state = "2-4"
	},
/obj/structure/cable{
	icon_state = "4-8"
	},
/obj/machinery/atmospherics/pipe/simple/scrubbers/hidden/layer4{
	dir = 1
	},
/turf/open/floor/plasteel/tech,
/area/template_noop)
"pX" = (
/obj/machinery/atmospherics/pipe/simple/orange/visible{
	dir = 6
	},
/obj/structure/cable{
	icon_state = "1-2"
	},
/obj/machinery/atmospherics/pipe/manifold/scrubbers/hidden/layer4{
	dir = 4
	},
/turf/open/floor/plasteel/tech,
/area/template_noop)
"qt" = (
/obj/machinery/atmospherics/pipe/simple/general/visible/layer4{
	dir = 6
	},
/turf/closed/wall/mineral/plastitanium,
/area/template_noop)
"qv" = (
/obj/machinery/door/airlock/public/glass/incinerator/atmos_exterior{
	dir = 4
	},
/turf/open/floor/engine,
/area/template_noop)
"qB" = (
/obj/machinery/atmospherics/pipe/simple/scrubbers/hidden/layer4{
	dir = 10
	},
/turf/closed/wall/mineral/plastitanium,
/area/template_noop)
"qC" = (
/obj/machinery/atmospherics/pipe/simple/cyan/visible/layer5,
/obj/structure/cable{
	icon_state = "1-2"
	},
/obj/machinery/atmospherics/pipe/simple/scrubbers/hidden/layer4{
	dir = 1
	},
/obj/machinery/atmospherics/pipe/manifold/supply/hidden/layer2{
	dir = 4
	},
/turf/open/floor/plasteel/tech,
/area/template_noop)
"qT" = (
/obj/machinery/atmospherics/components/unary/vent_pump/on/layer2{
	dir = 4
	},
/turf/open/floor/plasteel/tech,
/area/template_noop)
"qZ" = (
/obj/machinery/atmospherics/components/unary/vent_scrubber/on/layer3{
	dir = 4;
	filter_types = list("o2")
	},
/turf/open/floor/engine/hull/reinforced,
/area/template_noop)
"rD" = (
/obj/machinery/atmospherics/pipe/layer_manifold,
/obj/structure/cable{
	icon_state = "1-2"
	},
/turf/open/floor/plasteel/tech,
/area/template_noop)
"rY" = (
/obj/machinery/atmospherics/pipe/simple/orange/visible,
/turf/closed/wall/mineral/plastitanium,
/area/template_noop)
"sv" = (
/obj/machinery/atmospherics/pipe/simple/orange/visible{
	dir = 4
	},
/turf/open/floor/plasteel/tech,
/area/template_noop)
"sw" = (
/obj/machinery/air_sensor/atmos/oxygen_tank,
/turf/open/floor/engine/o2,
/area/template_noop)
"sY" = (
/obj/machinery/atmospherics/components/unary/vent_pump/siphon/atmos/nitrogen_output{
	dir = 8
	},
/turf/open/floor/engine/n2,
/area/template_noop)
"tg" = (
/obj/machinery/power/smes/engineering,
/obj/structure/cable{
	icon_state = "0-8"
	},
/obj/structure/cable{
	icon_state = "4-8"
	},
/turf/open/floor/plasteel/tech,
/area/template_noop)
"tJ" = (
/obj/machinery/atmospherics/components/unary/outlet_injector/atmos/incinerator_input{
	dir = 4;
	id_tag = "incinerator_in"
	},
/turf/open/floor/engine/vacuum,
/area/template_noop)
"tX" = (
/obj/machinery/atmospherics/components/trinary/filter/atmos/flipped/o2{
	dir = 10
	},
/turf/open/floor/plasteel/tech,
/area/template_noop)
"uv" = (
/obj/structure/cable{
	icon_state = "1-8"
	},
/obj/machinery/atmospherics/pipe/simple/supply/hidden/layer2,
/obj/machinery/atmospherics/components/unary/vent_scrubber/on/layer4{
	dir = 1
	},
/turf/open/floor/plasteel/tech,
/area/template_noop)
"uB" = (
/obj/structure/cable/yellow{
	icon_state = "1-2"
	},
/obj/machinery/atmospherics/components/trinary/filter/atmos/flipped/plasma{
	dir = 10
	},
/turf/open/floor/plasteel/tech,
/area/template_noop)
"vb" = (
/obj/machinery/atmospherics/pipe/simple/scrubbers/hidden/layer4{
	dir = 5
	},
/turf/closed/wall/mineral/plastitanium,
/area/template_noop)
"wj" = (
/obj/machinery/atmospherics/pipe/simple/dark/visible{
	dir = 1
	},
/obj/structure/cable{
	icon_state = "4-8"
	},
/turf/open/floor/plasteel/tech,
/area/template_noop)
"wx" = (
/obj/machinery/atmospherics/pipe/simple/general/visible/layer4{
	dir = 4
	},
/turf/closed/wall/mineral/plastitanium,
/area/template_noop)
"wX" = (
/obj/machinery/door/poddoor/incinerator_atmos_aux{
	dir = 4
	},
/turf/open/floor/engine,
/area/template_noop)
"xs" = (
/obj/machinery/atmospherics/pipe/simple/orange/visible,
/obj/structure/cable{
	icon_state = "1-2"
	},
/obj/machinery/atmospherics/pipe/simple/scrubbers/hidden/layer4{
	dir = 1
	},
/turf/open/floor/plasteel/tech,
/area/template_noop)
"xS" = (
/obj/machinery/atmospherics/pipe/simple/cyan/visible/layer5,
/obj/structure/cable{
	icon_state = "1-2"
	},
/obj/machinery/atmospherics/pipe/simple/scrubbers/hidden/layer4{
	dir = 1
	},
/obj/machinery/atmospherics/pipe/manifold/supply/hidden/layer2{
	dir = 1
	},
/turf/open/floor/plasteel/tech,
/area/template_noop)
"ya" = (
/obj/machinery/air_sensor/atmos/nitrous_tank,
/turf/open/floor/engine/n2,
/area/template_noop)
"zC" = (
/obj/machinery/atmospherics/pipe/simple/cyan/visible/layer5,
/obj/structure/cable{
	icon_state = "2-4"
	},
/obj/structure/cable{
	icon_state = "1-4"
	},
/obj/machinery/atmospherics/pipe/manifold/supply/hidden/layer2{
	dir = 8
	},
/obj/machinery/atmospherics/pipe/manifold/scrubbers/hidden/layer4{
	dir = 8
	},
/turf/open/floor/plasteel/tech,
/area/template_noop)
"zK" = (
/obj/machinery/atmospherics/pipe/simple/dark/visible{
	dir = 9
	},
/turf/closed/wall/mineral/plastitanium,
/area/template_noop)
"zO" = (
/obj/machinery/atmospherics/pipe/simple/supply/hidden/layer2{
	dir = 9
	},
/turf/open/floor/plasteel/tech,
/area/template_noop)
"AH" = (
/obj/machinery/atmospherics/pipe/simple/general/visible/layer4,
/obj/machinery/atmospherics/pipe/simple/supply/hidden/layer2{
	dir = 4
	},
/turf/open/floor/plasteel/tech,
/area/template_noop)
"Bl" = (
/obj/structure/cable{
	icon_state = "4-8"
	},
/turf/open/floor/plasteel/tech,
/area/template_noop)
"Bz" = (
/obj/structure/window/plasma/reinforced/plastitanium,
/obj/machinery/atmospherics/pipe/layer_manifold{
	dir = 4
	},
/turf/open/floor/engine,
/area/template_noop)
"BE" = (
/obj/machinery/atmospherics/components/unary/vent_pump/siphon/atmos/toxin_output{
	dir = 8
	},
/turf/open/floor/engine/plasma,
/area/template_noop)
"BS" = (
/obj/machinery/atmospherics/pipe/simple/cyan/visible/layer5,
/obj/machinery/atmospherics/pipe/simple/supply/hidden/layer2,
/obj/structure/cable{
	icon_state = "1-2"
	},
/obj/machinery/atmospherics/pipe/simple/scrubbers/hidden/layer4{
	dir = 1
	},
/turf/open/floor/plasteel/tech,
/area/template_noop)
"Ch" = (
/obj/structure/cable{
	icon_state = "1-2"
	},
/obj/machinery/atmospherics/pipe/simple/supply/hidden/layer2,
/obj/machinery/atmospherics/pipe/simple/scrubbers/hidden/layer4{
	dir = 1
	},
/turf/open/floor/plasteel/tech,
/area/template_noop)
"DA" = (
/obj/machinery/atmospherics/pipe/simple/cyan/visible,
/obj/machinery/atmospherics/pipe/simple/green/visible{
	dir = 4
	},
/obj/structure/cable{
	icon_state = "1-2"
	},
/obj/machinery/atmospherics/pipe/simple/supply/hidden/layer2,
/obj/machinery/atmospherics/pipe/simple/scrubbers/hidden/layer4{
	dir = 1
	},
/turf/open/floor/plasteel/tech,
/area/template_noop)
"DZ" = (
/obj/machinery/atmospherics/pipe/simple/cyan/visible/layer5{
	dir = 6
	},
/obj/machinery/atmospherics/pipe/simple/orange/visible{
	dir = 9
	},
/obj/structure/cable{
	icon_state = "1-2"
	},
/obj/machinery/atmospherics/pipe/simple/scrubbers/hidden/layer4{
	dir = 1
	},
/turf/open/floor/plasteel/tech,
/area/template_noop)
"Em" = (
/obj/machinery/atmospherics/components/unary/vent_pump/high_volume/siphon/atmos/air_output{
	dir = 8
	},
/turf/open/floor/engine/air,
/area/template_noop)
"EW" = (
/obj/machinery/atmospherics/components/unary/outlet_injector/atmos/oxygen_input{
	dir = 8
	},
/turf/open/floor/engine/o2,
/area/template_noop)
"Fc" = (
/obj/machinery/atmospherics/components/trinary/filter/atmos/flipped/n2{
	dir = 10
	},
/turf/open/floor/plasteel/tech,
/area/template_noop)
"FB" = (
/obj/machinery/power/terminal,
/obj/structure/cable{
	icon_state = "0-8"
	},
/turf/open/floor/plasteel/tech,
/area/template_noop)
"FJ" = (
/obj/structure/cable/yellow{
	icon_state = "1-2"
	},
/obj/machinery/atmospherics/pipe/simple/green/visible,
/obj/machinery/atmospherics/pipe/simple/scrubbers/hidden/layer4{
	dir = 4
	},
/turf/open/floor/plasteel/tech,
/area/template_noop)
"FM" = (
/obj/machinery/door/airlock/public/glass/incinerator/atmos_interior{
	dir = 4
	},
/turf/open/floor/engine,
/area/template_noop)
"Gc" = (
/obj/machinery/atmospherics/pipe/simple/orange/visible{
	dir = 6
	},
/turf/open/floor/plasteel/tech,
/area/template_noop)
"Gr" = (
/obj/structure/cable/yellow{
	icon_state = "1-2"
	},
/obj/machinery/atmospherics/pipe/layer_manifold,
/obj/structure/cable{
	icon_state = "4-8"
	},
/turf/open/floor/plasteel/tech,
/area/template_noop)
"GP" = (
/obj/machinery/atmospherics/pipe/manifold/scrubbers/hidden/layer4{
	dir = 1
	},
/turf/closed/wall/mineral/plastitanium,
/area/template_noop)
"Hz" = (
/obj/structure/cable/yellow{
	icon_state = "4-8"
	},
/obj/machinery/atmospherics/pipe/simple/scrubbers/hidden/layer4{
	dir = 1
	},
/turf/open/floor/plasteel/tech,
/area/template_noop)
"HL" = (
/obj/machinery/atmospherics/pipe/simple/scrubbers/hidden/layer2{
	dir = 4
	},
/turf/closed/wall/mineral/plastitanium,
/area/template_noop)
"HW" = (
/obj/machinery/atmospherics/components/unary/vent_pump/siphon/atmos/oxygen_output{
	dir = 8
	},
/turf/open/floor/engine/o2,
/area/template_noop)
"Kv" = (
/obj/structure/window/plasma/reinforced/plastitanium,
/turf/open/space/basic,
/area/template_noop)
"KH" = (
/obj/machinery/power/generator{
	dir = 8
	},
/obj/structure/cable/yellow{
	icon_state = "0-4"
	},
/turf/open/floor/plasteel/tech,
/area/template_noop)
"Lf" = (
/obj/machinery/atmospherics/pipe/simple/orange/visible,
/obj/machinery/atmospherics/components/binary/dp_vent_pump/high_volume/layer2,
/turf/open/floor/engine,
/area/template_noop)
"LY" = (
/obj/machinery/atmospherics/pipe/simple/general/visible/layer4,
/obj/structure/cable{
	icon_state = "4-8"
	},
/turf/open/floor/plasteel/tech,
/area/template_noop)
"Mr" = (
/turf/closed/wall/mineral/plastitanium,
/area/template_noop)
"NX" = (
/obj/structure/cable/yellow{
	icon_state = "1-8"
	},
/obj/machinery/atmospherics/pipe/simple/green/visible,
/turf/open/floor/plasteel/tech,
/area/template_noop)
"Oa" = (
/obj/machinery/atmospherics/pipe/simple/dark/visible,
/obj/machinery/atmospherics/pipe/simple/orange/visible{
	dir = 4
	},
/turf/open/floor/plasteel/tech,
/area/template_noop)
"Os" = (
/obj/machinery/atmospherics/pipe/simple/orange/visible{
	dir = 5
	},
/turf/open/floor/plasteel/tech,
/area/template_noop)
"Ot" = (
/obj/machinery/atmospherics/components/unary/outlet_injector/on,
/turf/open/floor/engine/hull/reinforced,
/area/template_noop)
"Pk" = (
/obj/machinery/power/shuttle/engine/electric{
	dir = 4
	},
/obj/structure/cable{
	icon_state = "0-4"
	},
/turf/open/floor/plating,
/area/template_noop)
"QB" = (
/obj/structure/window/plasma/reinforced/plastitanium,
/obj/machinery/atmospherics/pipe/simple/cyan/visible{
	dir = 4
	},
/turf/open/floor/engine,
/area/template_noop)
"QJ" = (
/obj/machinery/atmospherics/pipe/simple/dark/visible,
/turf/open/floor/plasteel/tech,
/area/template_noop)
"QO" = (
/obj/machinery/atmospherics/components/unary/vent_scrubber/on/layer4{
	dir = 4
	},
/turf/open/floor/plasteel/tech,
/area/template_noop)
"QZ" = (
/turf/open/floor/plasteel/tech,
/area/template_noop)
"Rc" = (
/obj/structure/cable{
	icon_state = "1-8"
	},
/turf/open/floor/plasteel/tech,
/area/template_noop)
"Rg" = (
/obj/machinery/atmospherics/pipe/simple/cyan/visible{
	dir = 5
	},
/obj/structure/cable{
	icon_state = "1-2"
	},
/obj/machinery/atmospherics/pipe/simple/supply/hidden/layer2,
/obj/machinery/atmospherics/pipe/simple/scrubbers/hidden/layer4{
	dir = 1
	},
/turf/open/floor/plasteel/tech,
/area/template_noop)
"Rq" = (
/turf/open/floor/plasteel/patterned/grid,
/area/template_noop)
"Sb" = (
/obj/machinery/atmospherics/pipe/simple/green/visible{
	dir = 4
	},
/obj/structure/cable{
	icon_state = "1-2"
	},
/obj/machinery/atmospherics/pipe/simple/scrubbers/hidden/layer4{
	dir = 1
	},
/turf/open/floor/plasteel/tech,
/area/template_noop)
"Sg" = (
/obj/machinery/atmospherics/components/binary/circulator,
/turf/open/floor/plasteel/tech,
/area/template_noop)
"Sw" = (
/obj/machinery/atmospherics/components/unary/shuttle/heater{
	dir = 4
	},
/obj/machinery/door/window/eastleft{
	name = "Engine Access"
	},
/turf/open/floor/plating,
/area/template_noop)
"TE" = (
/obj/structure/cable/yellow{
	icon_state = "1-2"
	},
/obj/machinery/atmospherics/pipe/simple/green/visible,
/turf/open/floor/plasteel/tech,
/area/template_noop)
"Us" = (
/obj/structure/cable{
	icon_state = "4-8"
	},
/obj/structure/cable{
	icon_state = "2-4"
	},
/obj/structure/cable{
	icon_state = "1-4"
	},
/turf/open/floor/plasteel/tech,
/area/template_noop)
"UC" = (
/obj/machinery/atmospherics/components/unary/outlet_injector/atmos/air_input{
	dir = 8
	},
/turf/open/floor/engine/air,
/area/template_noop)
"Vz" = (
/obj/machinery/air_sensor/atmos/toxin_tank,
/turf/open/floor/engine/plasma,
/area/template_noop)
"VH" = (
/obj/machinery/power/shuttle/engine/fueled/plasma{
	dir = 4
	},
/turf/open/floor/plating,
/area/template_noop)
"Wm" = (
/obj/machinery/power/terminal,
/obj/structure/cable{
	icon_state = "0-8"
	},
/obj/structure/cable{
	icon_state = "4-8"
	},
/turf/open/floor/plasteel/tech,
/area/template_noop)
"Wv" = (
/obj/machinery/atmospherics/pipe/simple/dark/visible,
/turf/closed/wall/mineral/plastitanium,
/area/template_noop)
"WU" = (
/obj/machinery/atmospherics/pipe/simple/green/visible,
/obj/machinery/atmospherics/pipe/layer_manifold{
	dir = 4
	},
/turf/open/floor/plasteel/tech,
/area/template_noop)
"Xi" = (
/obj/machinery/atmospherics/components/trinary/mixer/airmix{
	dir = 10
	},
/obj/structure/cable{
	icon_state = "1-2"
	},
/obj/machinery/atmospherics/pipe/simple/supply/hidden/layer2,
/obj/machinery/atmospherics/pipe/simple/scrubbers/hidden/layer4{
	dir = 1
	},
/turf/open/floor/plasteel/tech,
/area/template_noop)
"XX" = (
/obj/machinery/atmospherics/pipe/simple/green/visible,
/obj/machinery/atmospherics/pipe/simple/orange/visible{
	dir = 4
	},
/turf/open/floor/plasteel/tech,
/area/template_noop)
"Yu" = (
/obj/machinery/atmospherics/pipe/simple/dark/visible,
/obj/machinery/atmospherics/pipe/simple/dark/visible,
/turf/closed/wall/mineral/plastitanium,
/area/template_noop)
"YG" = (
/obj/machinery/power/terminal{
	dir = 8
	},
/obj/structure/cable{
	icon_state = "0-4"
	},
/turf/open/floor/plasteel/tech,
/area/template_noop)
"YW" = (
/obj/machinery/atmospherics/pipe/simple/scrubbers/hidden/layer4{
	dir = 8
	},
/turf/closed/wall/mineral/plastitanium,
/area/template_noop)
"YZ" = (
/obj/machinery/atmospherics/components/unary/outlet_injector/atmos/toxin_input{
	dir = 8
	},
/turf/open/floor/engine/plasma,
/area/template_noop)
"ZF" = (
/obj/effect/turf_decal/atmos/oxygen,
/turf/open/floor/engine/o2,
/area/template_noop)
"ZW" = (
/obj/machinery/atmospherics/pipe/simple/dark/visible{
	dir = 9
	},
/obj/machinery/atmospherics/pipe/simple/scrubbers/hidden/layer4{
	dir = 5
	},
/turf/open/floor/plasteel/tech,
/area/template_noop)

(1,1,1) = {"
iB
iB
iB
iB
iB
iB
iB
iB
iB
iB
iB
iB
iB
iB
Mr
Pk
Pk
Pk
VH
Mr
Mr
Mr
Mr
Mr
Mr
wX
Mr
Mr
Mr
Mr
Mr
Mr
VH
Pk
Pk
Pk
Mr
iB
iB
iB
iB
iB
iB
iB
iB
iB
iB
iB
iB
iB
iB
"}
(2,1,1) = {"
iB
iB
iB
iB
iB
iB
iB
iB
iB
iB
iB
iB
iB
Ot
vb
gs
gs
gs
Sw
Mr
QZ
Gc
Os
Mr
oV
eu
tJ
Mr
QZ
QZ
QZ
Mr
Sw
gs
gs
gs
Mr
qZ
iB
iB
iB
iB
iB
iB
iB
iB
iB
iB
iB
iB
iB
"}
(3,1,1) = {"
iB
iB
iB
iB
iB
iB
iB
iB
iB
iB
iB
iB
iB
Mr
YW
YG
YG
YG
QZ
cF
QJ
Oa
Oa
Yu
zK
qv
bW
Wv
QZ
QZ
QZ
QZ
QZ
YG
YG
YG
qt
mc
iB
iB
iB
iB
iB
iB
iB
iB
iB
iB
iB
iB
iB
"}
(4,1,1) = {"
iB
iB
iB
iB
iB
iB
iB
iB
iB
iB
iB
iB
Mr
Mr
YW
lc
Us
Rc
QO
Sg
KH
cW
nl
rY
eZ
Lf
bs
Mr
QZ
QZ
QZ
QZ
QZ
lc
fE
Rc
wx
Mr
Mr
iB
iB
iB
iB
iB
iB
iB
iB
iB
iB
iB
iB
"}
(5,1,1) = {"
iB
iB
iB
iB
iB
iB
iB
iB
iB
iB
iB
Mr
Mr
Rq
YW
cF
wj
fZ
dh
ZW
bI
sv
qT
Mr
iV
FM
HL
Mr
QZ
QZ
QZ
QZ
QZ
QZ
Bl
qT
wx
Rq
Mr
Mr
iB
iB
iB
iB
iB
iB
iB
iB
iB
iB
iB
"}
(6,1,1) = {"
iB
iB
iB
iB
iB
iB
iB
iB
iB
iB
Mr
Mr
Rq
Rq
GP
oa
Gr
TE
uB
FJ
NX
XX
in
mb
WU
mb
WU
mb
Fc
mb
mb
tX
mb
gt
LY
AH
mc
Rq
Rq
Mr
Mr
iB
iB
iB
iB
iB
iB
iB
iB
iB
iB
"}
(7,1,1) = {"
iB
iB
iB
iB
iB
iB
iB
iB
iB
Mr
Mr
Rq
Rq
Rq
qB
Hz
pn
kR
Sb
pX
xs
DZ
xS
BS
qC
zC
if
rD
DA
Xi
jA
DA
Rg
Ch
uv
zO
Mr
Rq
Rq
Rq
Mr
Mr
iB
iB
iB
iB
iB
iB
iB
iB
iB
"}
(8,1,1) = {"
iB
iB
iB
iB
iB
iB
iB
iB
Mr
Mr
Rq
Rq
Rq
Rq
Mr
Wm
tg
Mr
Bz
Bz
Mr
Bz
Bz
Mr
Mr
Bl
Mr
Mr
Bz
QB
Mr
Bz
QB
Mr
QZ
QZ
Mr
Rq
Rq
Rq
Rq
Mr
Mr
iB
iB
iB
iB
iB
iB
iB
iB
"}
(9,1,1) = {"
iB
iB
iB
iB
iB
iB
iB
Mr
Mr
Rq
Rq
Rq
Rq
Rq
Mr
Wm
tg
Mr
YZ
BE
Mr
UC
Em
Mr
QZ
Bl
QZ
Mr
bM
sY
Mr
EW
HW
Mr
QZ
QZ
Mr
Rq
Rq
Rq
Rq
Rq
Mr
Mr
iB
iB
iB
iB
iB
iB
iB
"}
(10,1,1) = {"
iB
iB
iB
iB
iB
iB
Mr
Mr
Rq
Rq
Rq
Rq
Rq
Rq
Mr
FB
gZ
Mr
aZ
Vz
Mr
gj
cj
Mr
QZ
Bl
QZ
Mr
nA
ya
Mr
ZF
sw
Mr
QZ
QZ
Mr
Rq
Rq
Rq
Rq
Rq
Rq
Mr
Mr
iB
iB
iB
iB
iB
iB
"}
(11,1,1) = {"
iB
iB
iB
iB
iB
Mr
Mr
Rq
Rq
Rq
Rq
Rq
Rq
Rq
Mr
QZ
Mr
Mr
Mr
Mr
Mr
Mr
Mr
Mr
Mr
QZ
Mr
Mr
Mr
Mr
Mr
Mr
Mr
Mr
Mr
QZ
Mr
Rq
Rq
Rq
Rq
Rq
Rq
Rq
Mr
Mr
iB
iB
iB
iB
iB
"}
(12,1,1) = {"
iB
iB
iB
iB
Mr
Mr
Rq
Rq
Rq
Rq
Rq
Rq
Rq
Rq
Mr
Mr
Mr
Rq
Rq
Rq
Rq
Rq
Rq
Rq
Rq
Rq
Rq
Rq
Rq
Rq
Rq
Rq
Rq
Rq
Mr
Mr
Mr
Rq
Rq
Rq
Rq
Rq
Rq
Rq
Rq
Mr
Mr
iB
iB
iB
iB
"}
(13,1,1) = {"
iB
iB
iB
Mr
Mr
Rq
Rq
Rq
Rq
Rq
Rq
Rq
Rq
Rq
Mr
Mr
Rq
Rq
Rq
Rq
Rq
Rq
Rq
Rq
Rq
Rq
Rq
Rq
Rq
Rq
Rq
Rq
Rq
Rq
Rq
Mr
Mr
Rq
Rq
Rq
Rq
Rq
Rq
Rq
Rq
Rq
Mr
Mr
iB
iB
iB
"}
(14,1,1) = {"
iB
iB
Mr
Mr
Rq
Rq
Rq
Rq
Rq
Rq
Rq
Rq
Rq
Mr
Mr
Rq
Rq
Rq
Mr
Mr
Mr
Mr
Mr
Mr
Rq
Rq
Rq
Mr
Mr
Mr
Mr
Mr
Mr
Rq
Rq
Rq
Mr
Mr
Rq
Rq
Rq
Rq
Rq
Rq
Rq
Rq
Rq
Mr
Mr
iB
iB
"}
(15,1,1) = {"
iB
Mr
Mr
Rq
Rq
Rq
Rq
Rq
Rq
Rq
Rq
Rq
Mr
Mr
Rq
Rq
Rq
Mr
Mr
iB
iB
iB
iB
Mr
Rq
Rq
Rq
Mr
iB
iB
iB
iB
Mr
Mr
Rq
Rq
Rq
Mr
Mr
Rq
Rq
Rq
Rq
Rq
Rq
Rq
Rq
Rq
Mr
Mr
iB
"}
(16,1,1) = {"
iB
Mr
Rq
Rq
Rq
Rq
Rq
Rq
Rq
Rq
Rq
Mr
Mr
Rq
Rq
Rq
Mr
Mr
iB
iB
iB
iB
iB
Mr
Rq
Rq
Rq
Mr
iB
iB
iB
iB
iB
Mr
Mr
Rq
Rq
Rq
Mr
Mr
Rq
Rq
Rq
Rq
Rq
Rq
Rq
Rq
Rq
Mr
iB
"}
(17,1,1) = {"
iB
Mr
Rq
Rq
Rq
Rq
Rq
Rq
Rq
Rq
Rq
Mr
Rq
Rq
Rq
Mr
Mr
iB
iB
iB
iB
iB
iB
Mr
Rq
Rq
Rq
Mr
iB
iB
iB
iB
iB
iB
Mr
Mr
Rq
Rq
Rq
Mr
Rq
Rq
Rq
Rq
Rq
Rq
Rq
Rq
Rq
Mr
iB
"}
(18,1,1) = {"
iB
Mr
Rq
Rq
Rq
Rq
Rq
Rq
Rq
Rq
Rq
Mr
Rq
Rq
Mr
Mr
iB
iB
iB
iB
iB
iB
iB
Mr
Rq
Rq
Rq
Mr
iB
iB
iB
iB
iB
iB
iB
Mr
Mr
Rq
Rq
Mr
Rq
Rq
Rq
Rq
Rq
Rq
Rq
Rq
Rq
Mr
iB
"}
(19,1,1) = {"
iB
Kv
Rq
Rq
Rq
Rq
Rq
Rq
Rq
Rq
Rq
Mr
Rq
Rq
Mr
iB
iB
iB
iB
iB
iB
iB
Mr
Mr
Mr
Rq
Mr
Mr
Mr
iB
iB
iB
iB
iB
iB
iB
Mr
Rq
Rq
Mr
Rq
Rq
Rq
Rq
Rq
Rq
Rq
Rq
Rq
Mr
iB
"}
(20,1,1) = {"
iB
Kv
Rq
Rq
Rq
Rq
Rq
Rq
Rq
Rq
Rq
Mr
Rq
Rq
Mr
iB
iB
iB
iB
iB
iB
Mr
Mr
Rq
Mr
Rq
Mr
Rq
Mr
Mr
iB
iB
iB
iB
iB
iB
Mr
Rq
Rq
Mr
Rq
Rq
Rq
Rq
Rq
Rq
Rq
Rq
Rq
Kv
iB
"}
(21,1,1) = {"
iB
Kv
Rq
Rq
Rq
Rq
Rq
Rq
Rq
Rq
Rq
Mr
Rq
Rq
Mr
iB
iB
iB
iB
iB
Mr
Mr
Rq
Rq
Mr
Rq
Mr
Rq
Rq
Mr
Mr
iB
iB
iB
iB
iB
Mr
Rq
Rq
Mr
Rq
Rq
Rq
Rq
Rq
Rq
Rq
Rq
Rq
Kv
iB
"}
(22,1,1) = {"
iB
Kv
Rq
Rq
Rq
Rq
Rq
Rq
Rq
Rq
Rq
Mr
Rq
Rq
Mr
iB
iB
iB
iB
Mr
Mr
Mr
Mr
Rq
Mr
Rq
Mr
Rq
Mr
Mr
Mr
Mr
iB
iB
iB
iB
Mr
Rq
Rq
Mr
Rq
Rq
Rq
Rq
Rq
Rq
Rq
Rq
Rq
Kv
iB
"}
(23,1,1) = {"
iB
Kv
Rq
Rq
Rq
Rq
Rq
Rq
Rq
Rq
Rq
Mr
Rq
Rq
Kv
iB
iB
iB
Mr
Mr
Rq
Mr
Rq
Rq
Rq
Rq
Rq
Rq
Rq
Mr
Rq
Mr
Mr
iB
iB
iB
Kv
Rq
Rq
Mr
Rq
Rq
Rq
Rq
Rq
Rq
Rq
Rq
Rq
Kv
iB
"}
(24,1,1) = {"
iB
Kv
Rq
Rq
Rq
Rq
Rq
Rq
Rq
Rq
Rq
Mr
Rq
Rq
Kv
iB
iB
iB
Mr
Rq
Rq
Mr
Rq
Mr
Mr
Mr
Mr
Mr
Rq
Mr
Rq
Rq
Mr
iB
iB
iB
Kv
Rq
Rq
Mr
Rq
Rq
Rq
Rq
Rq
Rq
Rq
Rq
Rq
Kv
iB
"}
(25,1,1) = {"
iB
Kv
Rq
Rq
Rq
Rq
Rq
Rq
Rq
Rq
Rq
Mr
Rq
Rq
Kv
iB
iB
iB
Mr
Rq
Rq
Mr
Rq
Mr
Rq
Rq
Rq
Mr
Rq
Mr
Rq
Rq
Mr
iB
iB
iB
Kv
Rq
Rq
Mr
Rq
Rq
Rq
Rq
Rq
Rq
Rq
Rq
Rq
Kv
iB
"}
(26,1,1) = {"
iB
Kv
Rq
Rq
Rq
Rq
Rq
Rq
Rq
Rq
Rq
Mr
Rq
Rq
Kv
iB
iB
iB
Mr
Rq
Rq
Rq
Rq
Mr
Rq
Rq
Rq
Mr
Rq
Rq
Rq
Rq
Mr
iB
iB
iB
Kv
Rq
Rq
Mr
Rq
Rq
Rq
Rq
Rq
Rq
Rq
Rq
Rq
Kv
iB
"}
(27,1,1) = {"
iB
Kv
Rq
Rq
Rq
Rq
Rq
Rq
Rq
Rq
Rq
Mr
Rq
Rq
Kv
iB
iB
iB
Mr
Rq
Rq
Mr
Rq
Mr
Rq
Rq
Rq
Mr
Rq
Mr
Rq
Rq
Mr
iB
iB
iB
Kv
Rq
Rq
Mr
Rq
Rq
Rq
Rq
Rq
Rq
Rq
Rq
Rq
Kv
iB
"}
(28,1,1) = {"
iB
Kv
Rq
Rq
Rq
Rq
Rq
Rq
Rq
Rq
Rq
Mr
Rq
Rq
Kv
iB
iB
iB
Mr
Rq
Rq
Mr
Rq
Mr
Mr
Rq
Mr
Mr
Rq
Mr
Rq
Rq
Mr
iB
iB
iB
Kv
Rq
Rq
Mr
Rq
Rq
Rq
Rq
Rq
Rq
Rq
Rq
Rq
Kv
iB
"}
(29,1,1) = {"
iB
Kv
Rq
Rq
Rq
Rq
Rq
Rq
Rq
Rq
Rq
Mr
Rq
Rq
Kv
iB
iB
iB
Mr
Mr
Mr
Mr
Rq
Rq
Rq
Rq
Rq
Rq
Rq
Mr
Mr
Mr
Mr
iB
iB
iB
Kv
Rq
Rq
Mr
Rq
Rq
Rq
Rq
Rq
Rq
Rq
Rq
Rq
Kv
iB
"}
(30,1,1) = {"
iB
Mr
Rq
Rq
Rq
Rq
Rq
Rq
Rq
Rq
Rq
Mr
Rq
Rq
Mr
iB
iB
iB
iB
Mr
Mr
Rq
Rq
Rq
Rq
Rq
Rq
Rq
Rq
Rq
Mr
Mr
iB
iB
iB
iB
Mr
Rq
Rq
Mr
Rq
Rq
Rq
Rq
Rq
Rq
Rq
Rq
Rq
Mr
iB
"}
(31,1,1) = {"
iB
Mr
Rq
Rq
Rq
Rq
Rq
Rq
Rq
Rq
Rq
Mr
Rq
Rq
Mr
iB
iB
iB
iB
iB
Mr
Mr
Rq
Rq
Rq
Rq
Rq
Rq
Rq
Mr
Mr
iB
iB
iB
iB
iB
Mr
Rq
Rq
Mr
Rq
Rq
Rq
Rq
Rq
Rq
Rq
Rq
Rq
Mr
iB
"}
(32,1,1) = {"
iB
Mr
Rq
Rq
Rq
Rq
Rq
Rq
Rq
Rq
Rq
Mr
Rq
Rq
Mr
iB
iB
iB
iB
iB
iB
Mr
Mr
Rq
Rq
Rq
Rq
Rq
Mr
Mr
iB
iB
iB
iB
iB
iB
Mr
Rq
Rq
Mr
Rq
Rq
Rq
Rq
Rq
Rq
Rq
Rq
Rq
Mr
iB
"}
(33,1,1) = {"
iB
Mr
Rq
Rq
Rq
Rq
Rq
Rq
Rq
Rq
Rq
Mr
Rq
Rq
Mr
iB
iB
iB
iB
iB
iB
iB
Mr
iY
iY
iY
iY
iY
Mr
iB
iB
iB
iB
iB
iB
iB
Mr
Rq
Rq
Mr
Rq
Rq
Rq
Rq
Rq
Rq
Rq
Rq
Rq
Mr
iB
"}
(34,1,1) = {"
iB
Mr
Mr
Mr
Mr
Mr
Mr
Mr
Mr
Mr
Mr
Mr
Rq
Rq
Mr
Mr
iB
iB
iB
iB
iB
iB
iB
iB
iB
iB
iB
iB
iB
iB
iB
iB
iB
iB
iB
Mr
Mr
Rq
Rq
Mr
Mr
Mr
Mr
Mr
Mr
Mr
Mr
Mr
Mr
Mr
iB
"}
(35,1,1) = {"
iB
Mr
Rq
Rq
Rq
Rq
Rq
Rq
Rq
Rq
Rq
Rq
Rq
Rq
Rq
Mr
Mr
iB
iB
iB
iB
iB
iB
iB
iB
iB
iB
iB
iB
iB
iB
iB
iB
iB
Mr
Mr
Rq
Rq
Rq
Rq
Rq
Rq
Rq
Rq
Rq
Rq
Rq
Rq
Rq
Mr
iB
"}
(36,1,1) = {"
iB
Mr
Rq
Rq
Rq
Rq
Rq
Rq
Rq
Rq
Rq
Rq
Rq
Rq
Rq
Rq
Mr
Mr
iB
iB
iB
iB
iB
iB
iB
iB
iB
iB
iB
iB
iB
iB
iB
iB
Mr
Rq
Rq
Rq
Rq
Rq
Rq
Rq
Rq
Rq
Rq
Rq
Rq
Rq
Rq
Mr
iB
"}
(37,1,1) = {"
iB
Mr
Rq
Rq
Rq
Rq
Rq
Rq
Rq
Rq
Rq
Rq
Rq
Rq
Rq
Rq
Rq
Mr
Mr
iB
iB
iB
iB
iB
iB
iB
iB
iB
iB
iB
iB
iB
Mr
Mr
Rq
Rq
Rq
Rq
Rq
Rq
Rq
Rq
Rq
Rq
Rq
Rq
Rq
Rq
Rq
Mr
iB
"}
(38,1,1) = {"
iB
Mr
Mr
Rq
Rq
Rq
Rq
Rq
Rq
Rq
Rq
Rq
Rq
Rq
Rq
Rq
Rq
Rq
Mr
iB
iB
iB
iB
iB
iB
iB
iB
iB
iB
iB
iB
iB
Mr
Rq
Rq
Rq
Rq
Rq
Rq
Rq
Rq
Rq
Rq
Rq
Rq
Rq
Rq
Rq
Mr
Mr
iB
"}
(39,1,1) = {"
iB
iB
Mr
Mr
Rq
Rq
Rq
Rq
Rq
Rq
Rq
Rq
Rq
Rq
Rq
Rq
Rq
Rq
Rq
iB
iB
iB
iB
iB
iB
iB
iB
iB
iB
iB
iB
iB
Rq
Rq
Rq
Rq
Rq
Rq
Rq
Rq
Rq
Rq
Rq
Rq
Rq
Rq
Rq
Mr
Mr
iB
iB
"}
(40,1,1) = {"
iB
iB
iB
Mr
Mr
Rq
Rq
Rq
Rq
Rq
Rq
Rq
Rq
Rq
Rq
Rq
Rq
Rq
Rq
iB
iB
iB
iB
iB
iB
iB
iB
iB
iB
iB
iB
iB
Rq
Rq
Rq
Rq
Rq
Rq
Rq
Rq
Rq
Rq
Rq
Rq
Rq
Rq
Mr
Mr
iB
iB
iB
"}
(41,1,1) = {"
iB
iB
iB
iB
Mr
Mr
Rq
Rq
Rq
Rq
Rq
Rq
Rq
Rq
Rq
Rq
Rq
Rq
Rq
iB
iB
iB
iB
iB
iB
iB
iB
iB
iB
iB
iB
iB
Rq
Rq
Rq
Rq
Rq
Rq
Rq
Rq
Rq
Rq
Rq
Rq
Rq
Mr
Mr
iB
iB
iB
iB
"}
(42,1,1) = {"
iB
iB
iB
iB
iB
Mr
Mr
Rq
Rq
Rq
Rq
Rq
Rq
Rq
Rq
Rq
Rq
Rq
Rq
iB
iB
iB
iB
iB
iB
iB
iB
iB
iB
iB
iB
iB
Rq
Rq
Rq
Rq
Rq
Rq
Rq
Rq
Rq
Rq
Rq
Rq
Mr
Mr
iB
iB
iB
iB
iB
"}
(43,1,1) = {"
iB
iB
iB
iB
iB
iB
Mr
Mr
Rq
Rq
Rq
Rq
Rq
Rq
Rq
Rq
Rq
Rq
Rq
iB
iB
iB
iB
iB
iB
iB
iB
iB
iB
iB
iB
iB
Rq
Rq
Rq
Rq
Rq
Rq
Rq
Rq
Rq
Rq
Rq
Mr
Mr
iB
iB
iB
iB
iB
iB
"}
(44,1,1) = {"
iB
iB
iB
iB
iB
iB
iB
Mr
Mr
Rq
Rq
Rq
Rq
Rq
Rq
Rq
Rq
Rq
Rq
iB
iB
iB
iB
iB
iB
iB
iB
iB
iB
iB
iB
iB
Rq
Rq
Rq
Rq
Rq
Rq
Rq
Rq
Rq
Rq
Mr
Mr
iB
iB
iB
iB
iB
iB
iB
"}
(45,1,1) = {"
iB
iB
iB
iB
iB
iB
iB
iB
Mr
Mr
Rq
Rq
Rq
Rq
Rq
Rq
Rq
Rq
Rq
iB
iB
iB
iB
iB
iB
iB
iB
iB
iB
iB
iB
iB
Rq
Rq
Rq
Rq
Rq
Rq
Rq
Rq
Rq
Mr
Mr
iB
iB
iB
iB
iB
iB
iB
iB
"}
(46,1,1) = {"
iB
iB
iB
iB
iB
iB
iB
iB
iB
Mr
Mr
Rq
Rq
Rq
Rq
Rq
Rq
Rq
Rq
iB
iB
iB
iB
iB
iB
iB
iB
iB
iB
iB
iB
iB
Rq
Rq
Rq
Rq
Rq
Rq
Rq
Rq
Mr
Mr
iB
iB
iB
iB
iB
iB
iB
iB
iB
"}
(47,1,1) = {"
iB
iB
iB
iB
iB
iB
iB
iB
iB
iB
Mr
Mr
Rq
Rq
Rq
Rq
Rq
Rq
Rq
iB
iB
iB
iB
iB
iB
iB
iB
iB
iB
iB
iB
iB
Rq
Rq
Rq
Rq
Rq
Rq
Rq
Mr
Mr
iB
iB
iB
iB
iB
iB
iB
iB
iB
iB
"}
(48,1,1) = {"
iB
iB
iB
iB
iB
iB
iB
iB
iB
iB
iB
Mr
Mr
Rq
Rq
Rq
Rq
Rq
Mr
iB
iB
iB
iB
iB
iB
iB
iB
iB
iB
iB
iB
iB
Mr
Rq
Rq
Rq
Rq
Rq
Mr
Mr
iB
iB
iB
iB
iB
iB
iB
iB
iB
iB
iB
"}
(49,1,1) = {"
iB
iB
iB
iB
iB
iB
iB
iB
iB
iB
iB
iB
Mr
Mr
Mr
Mr
Mr
Mr
Mr
iB
iB
iB
iB
iB
iB
iB
iB
iB
iB
iB
iB
iB
Mr
Mr
Mr
Mr
Mr
Mr
Mr
iB
iB
iB
iB
iB
iB
iB
iB
iB
iB
iB
iB
"}
(50,1,1) = {"
iB
iB
iB
iB
iB
iB
iB
iB
iB
iB
iB
iB
iB
iB
iB
iB
iB
iB
iB
iB
iB
iB
iB
iB
iB
iB
iB
iB
iB
iB
iB
iB
iB
iB
iB
iB
iB
iB
iB
iB
iB
iB
iB
iB
iB
iB
iB
iB
iB
iB
iB
"}
(51,1,1) = {"
iB
iB
iB
iB
iB
iB
iB
iB
iB
iB
iB
iB
iB
iB
iB
iB
iB
iB
iB
iB
iB
iB
iB
iB
iB
iB
iB
iB
iB
iB
iB
iB
iB
iB
iB
iB
iB
iB
iB
iB
iB
iB
iB
iB
iB
iB
iB
iB
iB
iB
iB
"}
