//MAP CONVERTED BY dmm2tgm.py THIS HEADER COMMENT PREVENTS RECONVERSION, DO NOT REMOVE
"a" = (
/turf/closed/wall/mineral/plastitanium,
/area/space)
"d" = (
/turf/open/floor/plasteel/patterned/grid,
/area/space)
"j" = (
/turf/open/space/basic,
/area/space)
"B" = (
/obj/structure/window/plasma/reinforced/plastitanium,
/turf/open/space/basic,
/area/space)
"M" = (
/obj/structure/window/plasma/reinforced/plastitanium,
/turf/open/floor/plasteel/patterned/grid,
/area/space)

(1,1,1) = {"
j
j
j
j
j
j
j
j
j
j
j
j
j
j
a
a
a
a
a
a
j
a
a
a
a
a
a
a
a
a
j
a
a
a
a
a
a
j
j
j
j
j
j
j
j
j
j
j
j
j
j
"}
(2,1,1) = {"
j
j
j
j
j
j
j
j
j
j
j
j
j
j
a
d
d
d
d
a
j
a
d
a
d
d
d
a
d
a
j
a
d
d
d
d
a
j
j
j
j
j
j
j
j
j
j
j
j
j
j
"}
(3,1,1) = {"
j
j
j
j
j
j
j
j
j
j
j
j
j
a
a
d
d
d
d
a
a
a
d
a
a
d
a
a
d
a
a
a
d
d
d
d
a
a
j
j
j
j
j
j
j
j
j
j
j
j
j
"}
(4,1,1) = {"
j
j
j
j
j
j
j
j
j
j
j
j
a
a
a
d
d
d
d
d
d
d
d
a
d
d
d
a
d
d
d
d
d
d
d
d
a
a
a
j
j
j
j
j
j
j
j
j
j
j
j
"}
(5,1,1) = {"
j
j
j
j
j
j
j
j
j
j
j
a
a
d
a
d
d
d
d
d
d
d
d
a
a
d
a
a
d
d
d
d
d
d
d
d
a
d
a
a
j
j
j
j
j
j
j
j
j
j
j
"}
(6,1,1) = {"
j
j
j
j
j
j
j
j
j
j
a
a
d
d
a
d
d
d
d
d
d
d
d
d
d
d
d
d
d
d
d
d
d
d
d
d
a
d
d
a
a
j
j
j
j
j
j
j
j
j
j
"}
(7,1,1) = {"
j
j
j
j
j
j
j
j
j
a
a
d
d
d
a
d
d
d
d
d
d
d
d
d
d
d
d
d
d
d
d
d
d
d
d
d
a
d
d
d
a
a
j
j
j
j
j
j
j
j
j
"}
(8,1,1) = {"
j
j
j
j
j
j
j
j
a
a
d
d
d
d
a
d
d
a
M
M
a
M
M
a
a
d
a
a
M
M
a
M
M
a
d
d
a
d
d
d
d
a
a
j
j
j
j
j
j
j
j
"}
(9,1,1) = {"
j
j
j
j
j
j
j
a
a
d
d
d
d
d
a
d
d
a
d
d
a
d
d
a
d
d
d
a
d
d
a
d
d
a
d
d
a
d
d
d
d
d
a
a
j
j
j
j
j
j
j
"}
(10,1,1) = {"
j
j
j
j
j
j
a
a
d
d
d
d
d
d
a
d
d
a
d
d
a
d
d
a
d
d
d
a
d
d
a
d
d
a
d
d
a
d
d
d
d
d
d
a
a
j
j
j
j
j
j
"}
(11,1,1) = {"
j
j
j
j
j
a
a
d
d
d
d
d
d
d
a
d
a
a
a
a
a
a
a
a
a
d
a
a
a
a
a
a
a
a
a
d
a
d
d
d
d
d
d
d
a
a
j
j
j
j
j
"}
(12,1,1) = {"
j
j
j
j
a
a
d
d
d
d
d
d
d
d
a
a
a
d
d
d
d
d
d
d
d
d
d
d
d
d
d
d
d
d
a
a
a
d
d
d
d
d
d
d
d
a
a
j
j
j
j
"}
(13,1,1) = {"
j
j
j
a
a
d
d
d
d
d
d
d
d
d
a
a
d
d
d
d
d
d
d
d
d
d
d
d
d
d
d
d
d
d
d
a
a
d
d
d
d
d
d
d
d
d
a
a
j
j
j
"}
(14,1,1) = {"
j
j
a
a
d
d
d
d
d
d
d
d
d
a
a
d
d
d
a
a
a
a
a
a
d
d
d
a
a
a
a
a
a
d
d
d
a
a
d
d
d
d
d
d
d
d
d
a
a
j
j
"}
(15,1,1) = {"
j
a
a
d
d
d
d
d
d
d
d
d
a
a
d
d
d
a
a
j
j
j
j
a
d
d
d
a
j
j
j
j
a
a
d
d
d
a
a
d
d
d
d
d
d
d
d
d
a
a
j
"}
(16,1,1) = {"
j
a
d
d
d
d
d
d
d
d
d
a
a
d
d
d
a
a
j
j
j
j
j
a
d
d
d
a
j
j
j
j
j
a
a
d
d
d
a
a
d
d
d
d
d
d
d
d
d
a
j
"}
(17,1,1) = {"
j
a
d
d
d
d
d
d
d
d
d
a
d
d
d
a
a
j
j
j
j
j
j
a
d
d
d
a
j
j
j
j
j
j
a
a
d
d
d
a
d
d
d
d
d
d
d
d
d
a
j
"}
(18,1,1) = {"
j
a
d
d
d
d
d
d
d
d
d
a
d
d
a
a
j
j
j
j
j
j
j
a
d
d
d
a
j
j
j
j
j
j
j
a
a
d
d
a
d
d
d
d
d
d
d
d
d
a
j
"}
(19,1,1) = {"
j
B
d
d
d
d
d
d
d
d
d
a
d
d
a
j
j
j
j
j
j
j
a
a
a
d
a
a
a
j
j
j
j
j
j
j
a
d
d
a
d
d
d
d
d
d
d
d
d
a
j
"}
(20,1,1) = {"
j
B
d
d
d
d
d
d
d
d
d
a
d
d
a
j
j
j
j
j
j
a
a
d
a
d
a
d
a
a
j
j
j
j
j
j
a
d
d
a
d
d
d
d
d
d
d
d
d
B
j
"}
(21,1,1) = {"
j
B
d
d
d
d
d
d
d
d
d
a
d
d
a
j
j
j
j
j
a
a
d
d
a
d
a
d
d
a
a
j
j
j
j
j
a
d
d
a
d
d
d
d
d
d
d
d
d
B
j
"}
(22,1,1) = {"
j
B
d
d
d
d
d
d
d
d
d
a
d
d
a
j
j
j
j
a
a
a
a
d
a
d
a
d
a
a
a
a
j
j
j
j
a
d
d
a
d
d
d
d
d
d
d
d
d
B
j
"}
(23,1,1) = {"
j
B
d
d
d
d
d
d
d
d
d
a
d
d
B
j
j
j
a
a
d
a
d
d
d
d
d
d
d
a
d
a
a
j
j
j
B
d
d
a
d
d
d
d
d
d
d
d
d
B
j
"}
(24,1,1) = {"
j
B
d
d
d
d
d
d
d
d
d
a
d
d
B
j
j
j
a
d
d
a
d
a
a
a
a
a
d
a
d
d
a
j
j
j
B
d
d
a
d
d
d
d
d
d
d
d
d
B
j
"}
(25,1,1) = {"
j
B
d
d
d
d
d
d
d
d
d
a
d
d
B
j
j
j
a
d
d
a
d
a
d
d
d
a
d
a
d
d
a
j
j
j
B
d
d
a
d
d
d
d
d
d
d
d
d
B
j
"}
(26,1,1) = {"
j
B
d
d
d
d
d
d
d
d
d
a
d
d
B
j
j
j
a
d
d
d
d
a
d
d
d
a
d
d
d
d
a
j
j
j
B
d
d
a
d
d
d
d
d
d
d
d
d
B
j
"}
(27,1,1) = {"
j
B
d
d
d
d
d
d
d
d
d
a
d
d
B
j
j
j
a
d
d
a
d
a
d
d
d
a
d
a
d
d
a
j
j
j
B
d
d
a
d
d
d
d
d
d
d
d
d
B
j
"}
(28,1,1) = {"
j
B
d
d
d
d
d
d
d
d
d
a
d
d
B
j
j
j
a
d
d
a
d
a
a
d
a
a
d
a
d
d
a
j
j
j
B
d
d
a
d
d
d
d
d
d
d
d
d
B
j
"}
(29,1,1) = {"
j
B
d
d
d
d
d
d
d
d
d
a
d
d
B
j
j
j
a
a
a
a
d
d
d
d
d
d
d
a
a
a
a
j
j
j
B
d
d
a
d
d
d
d
d
d
d
d
d
B
j
"}
(30,1,1) = {"
j
a
d
d
d
d
d
d
d
d
d
a
d
d
a
j
j
j
j
a
a
d
d
d
d
d
d
d
d
d
a
a
j
j
j
j
a
d
d
a
d
d
d
d
d
d
d
d
d
a
j
"}
(31,1,1) = {"
j
a
d
d
d
d
d
d
d
d
d
a
d
d
a
j
j
j
j
j
a
a
d
d
d
d
d
d
d
a
a
j
j
j
j
j
a
d
d
a
d
d
d
d
d
d
d
d
d
a
j
"}
(32,1,1) = {"
j
a
d
d
d
d
d
d
d
d
d
a
d
d
a
j
j
j
j
j
j
a
a
d
d
d
d
d
a
a
j
j
j
j
j
j
a
d
d
a
d
d
d
d
d
d
d
d
d
a
j
"}
(33,1,1) = {"
j
a
d
d
d
d
d
d
d
d
d
a
d
d
a
j
j
j
j
j
j
j
a
M
M
M
M
M
a
j
j
j
j
j
j
j
a
d
d
a
d
d
d
d
d
d
d
d
d
a
j
"}
(34,1,1) = {"
j
a
a
a
a
a
a
a
a
a
a
a
d
d
a
a
j
j
j
j
j
j
j
j
j
j
j
j
j
j
j
j
j
j
j
a
a
d
d
a
a
a
a
a
a
a
a
a
a
a
j
"}
(35,1,1) = {"
j
a
d
d
d
d
d
d
d
d
d
d
d
d
d
a
a
j
j
j
j
j
j
j
j
j
j
j
j
j
j
j
j
j
a
a
d
d
d
d
d
d
d
d
d
d
d
d
d
a
j
"}
(36,1,1) = {"
j
a
d
d
d
d
d
d
d
d
d
d
d
d
d
d
a
a
j
j
j
j
j
j
j
j
j
j
j
j
j
j
j
a
a
d
d
d
d
d
d
d
d
d
d
d
d
d
d
a
j
"}
(37,1,1) = {"
j
a
d
d
d
d
d
d
d
d
d
d
d
d
d
d
d
a
a
j
j
j
j
j
j
j
j
j
j
j
j
j
a
a
d
d
d
d
d
d
d
d
d
d
d
d
d
d
d
a
j
"}
(38,1,1) = {"
j
a
a
d
d
d
d
d
d
d
d
d
d
d
d
d
d
d
a
j
j
j
j
j
j
j
j
j
j
j
j
j
a
d
d
d
d
d
d
d
d
d
d
d
d
d
d
d
a
a
j
"}
(39,1,1) = {"
j
j
a
a
d
d
d
d
d
d
d
d
d
d
d
d
d
d
d
j
j
j
j
j
j
j
j
j
j
j
j
j
d
d
d
d
d
d
d
d
d
d
d
d
d
d
d
a
a
j
j
"}
(40,1,1) = {"
j
j
j
a
a
d
d
d
d
d
d
d
d
d
d
d
d
d
d
j
j
j
j
j
j
j
j
j
j
j
j
j
d
d
d
d
d
d
d
d
d
d
d
d
d
d
a
a
j
j
j
"}
(41,1,1) = {"
j
j
j
j
a
a
d
d
d
d
d
d
d
d
d
d
d
d
d
j
j
j
j
j
j
j
j
j
j
j
j
j
d
d
d
d
d
d
d
d
d
d
d
d
d
a
a
j
j
j
j
"}
(42,1,1) = {"
j
j
j
j
j
a
a
d
d
d
d
d
d
d
d
d
d
d
d
j
j
j
j
j
j
j
j
j
j
j
j
j
d
d
d
d
d
d
d
d
d
d
d
d
a
a
j
j
j
j
j
"}
(43,1,1) = {"
j
j
j
j
j
j
a
a
d
d
d
d
d
d
d
d
d
d
d
j
j
j
j
j
j
j
j
j
j
j
j
j
d
d
d
d
d
d
d
d
d
d
d
a
a
j
j
j
j
j
j
"}
(44,1,1) = {"
j
j
j
j
j
j
j
a
a
d
d
d
d
d
d
d
d
d
d
j
j
j
j
j
j
j
j
j
j
j
j
j
d
d
d
d
d
d
d
d
d
d
a
a
j
j
j
j
j
j
j
"}
(45,1,1) = {"
j
j
j
j
j
j
j
j
a
a
d
d
d
d
d
d
d
d
d
j
j
j
j
j
j
j
j
j
j
j
j
j
d
d
d
d
d
d
d
d
d
a
a
j
j
j
j
j
j
j
j
"}
(46,1,1) = {"
j
j
j
j
j
j
j
j
j
a
a
d
d
d
d
d
d
d
d
j
j
j
j
j
j
j
j
j
j
j
j
j
d
d
d
d
d
d
d
d
a
a
j
j
j
j
j
j
j
j
j
"}
(47,1,1) = {"
j
j
j
j
j
j
j
j
j
j
a
a
d
d
d
d
d
d
d
j
j
j
j
j
j
j
j
j
j
j
j
j
d
d
d
d
d
d
d
a
a
j
j
j
j
j
j
j
j
j
j
"}
(48,1,1) = {"
j
j
j
j
j
j
j
j
j
j
j
a
a
d
d
d
d
d
a
j
j
j
j
j
j
j
j
j
j
j
j
j
a
d
d
d
d
d
a
a
j
j
j
j
j
j
j
j
j
j
j
"}
(49,1,1) = {"
j
j
j
j
j
j
j
j
j
j
j
j
a
a
a
a
a
a
a
j
j
j
j
j
j
j
j
j
j
j
j
j
a
a
a
a
a
a
a
j
j
j
j
j
j
j
j
j
j
j
j
"}
(50,1,1) = {"
j
j
j
j
j
j
j
j
j
j
j
j
j
j
j
j
j
j
j
j
j
j
j
j
j
j
j
j
j
j
j
j
j
j
j
j
j
j
j
j
j
j
j
j
j
j
j
j
j
j
j
"}
(51,1,1) = {"
j
j
j
j
j
j
j
j
j
j
j
j
j
j
j
j
j
j
j
j
j
j
j
j
j
j
j
j
j
j
j
j
j
j
j
j
j
j
j
j
j
j
j
j
j
j
j
j
j
j
j
"}
